1111111111111111111111111111111111
1E00C0000000000C00000C000000000001
1111110100100000101001000000010101
1010010010101010001001000000010101
1P0000000C00C000000000000000000001
1111111111111111111111111111111111