111111111111111111111111111111111111111111111
100000000000000C00000C00000000000000000010101
1010010100100000101001000000010100000000000C1
1010010010101010001001000000010100000000000C1
1P0000000C00C0000000000000000000C000000010101
1E0000000000000C00000C000000000000000000000C1
101001010010000010100100000001010000000010101
1010010010101010001001000000010100000000000C1
110000000C00C0000000000000000000C0000000000C1
100000000000000C00000C00000000000000000010101
1010010100100000101001000000010100000000000C1
1010010010101010001001000000010100000000000C1
100000000C00C0000000000000000000C000000010101
111111111111100000000000000000001111111111111
110000000C00C0000000000000000000C0000000000C1
100000000000000C00000C00000000000000000010101
1010010100100000101001000000010100000000000C1
1010010010101010001001000000010100000000000C1
100000000C00C0000000000000000000C000000010101
111111111111100000000000000000001111111111111
110000000C00C0000000000000000000C0000000000C1
100000000000000C00000C00000000000000000010101
1010010100100000101001000000010100000000000C1
111111111111100000000000000000001111111111111
110000000C00C0000000000000000000C0000000000C1
100000000000000C00000C00000000000000000010101
1010010100100000101001000000010100000000000C1
1010010010101010001001000000010100000000000C1
100000000C00C0000000000000000000C000000010101
111111111111111111111111111111111111111111111