1111111111111111111111111111111111111111111
100000000000000C00000C000000000000000010101
10100101001000001010010000000101000000000C1
10100100101010100010010000000101000000000C1
1P0000000C00C00000000000000000C000000010101
1E0000000000000C00000C0000000000000000000C1
1010010100100000101001000001010000000010101
10100100101010100010010000010100000000000C1
110000000C00C00000000000000000C0000000000C1
100000000000000C000000000000000000000010101
10100101001000001011000000010100000000000C1
10100100101010101001000000010100000000000C1
100000000C00C00000000000000000C000000010101
1111111111111111111111111111111111111111111